// https://github.com/dustypomerleau/eye-notes

(+) - preferred over (>), e.g. 'age 40+,' not 'age > 40'
(-) - preferred over (<), e.g. 'vision 6/12-,' not 'vision < 6/12'
(V|AV|L)M - venous, arteriovenous, or lymphatic malformation
(∆) - prism, prism diopters, change
(°) - degrees, OR after a number: primary (1°), secondary (2°), and so on
5FU - 5 fluorouracil
AACG - acute angle closure glaucoma
AAION - arteritic anterior ischemic optic neuropathy
AAK - aniridia associated keratitis
AAO - American Academy of Ophthalmology
Ab - antibody
ABG - arterial blood gas
AC - anterior chamber
AC/A - accomodative convergence to accomodation ratio
ACCS - anterior capsule contraction syndrome
ACD - anterior chamber depth
ACE - angiotensin converting enzyme
ACG - angle closure glaucoma
ACIOL - anterior chamber intraocular lens
ACR - American College of Rheumatology
ACTH - adrenocorticotropic hormone
ACV - aciclovir
AD - autosomal dominant
ADL - activities of daily living
AGIS - Advanced Glaucoma Intervention Study
AHP - abnormal head position
AIDS - acquired immune deficiency syndrome
AION - anterior ischemic optic neuropathy
AKA - also known as
AKC - atopic keratoconjunctivitis
AL - axial length
ALL - acute lymphoblastic leukemia
ALPI -argon laser peripheral iridoplasty
ALT - argon laser trabeculoplasty
AMD - age related macular degeneration
AML - acute myelogenous leukemia
AMN - acute macular neuroretinopathy
ANA - antinuclear antibody
ANCA - antineutrophil cytoplasmic antibody
AO - adaptive optics, Archives of Ophthalmology
AOT - as opposed to
APAC - acute primary angle closure
APACRS - Asia Pacific Association of Cataract and Refractive Surgeons
APD - afferent pupillary defect
APMPPE - acute posterior multifocal placoid pigment epitheliopathy
AR - autosomal recessive
ARC - abnormal retinal correspondence
ARDS - acute respiratory distress syndrome
AREDS - Age Related Eye Disease Study
ARN - acute retinal necrosis
ARPE - acute retinal pigment epitheliitis
ARR - absolute relative risk
AS - ankylosing spondylitis
ASA - acetylsalicylic acid
ASAP - as soon as possible
ASCRS - American Society of Cataract and Refractive Surgeons
ASD - anterior segment dysgenesis
ASI - anterior segment ischemia
ASRS - American Society of Retina Specialists
ASUS - A scan ultrasound
AT - artificial tears
ATD - aqueous tear deficiency
ATM - anterior trabecular meshwork
ATR - against the rule
ATT  - argon laser trabeculoplasty, trabeculectomy, trabeculectomy
AU - Australia
AUNGAU - acute unilateral nongranulomatous anterior uveitis
AV - anterior vitreous
AVE - average cell area
AVED - ataxia with isolated vitamin E deficiency
AVL - adult vitelliform lesion
AVM - arteriovenous malformation
BAC - benzalkonium chloride
BAF - blue autofluorescence
BAM - benign acquired melanosis
BCC - basal cell carcinoma
BCM - blue cone monochromatism
BCSC - AAO Basic and Clinical Science Course
BCTL - bandage contact lens
BCVA - best corrected visual acuity
BD - base down
BDES - Beaver Dam Eye Study
BDUMP - bilateral diffuse uveal melanocytic precipitates
BHID - benign hereditary intraepithelial dyskeratosis
BHTT - Bielkowsky head tilt test
BI - base in
BIO - binocular indirect ophthalmoscope
BL - bilateral
BLamD - basal laminar deposit
BLinD - basal linear deposit
BMES - Blue Mountains Eye Study
BO - base out
BoY - blue on yellow
BP - blood pressure
BR - blue reflectance
BRAF - the protooncogene encoding B raf protein
BRAFI - BRAF inhibitors (vemurafenib, dabrafenib)
BRAO - branch retinal artery occlusion
BRVO - branch retinal vein occlusion
BSA - body surface area
BSCR - birdshot chorioretinopathy
BSS - balanced saline solution
BSUS - B scan ultrasound
BU - base up
BVN - branching vascular network
CA - cancer, carcinoma
CABG - coronary artery bypass graft
CACD - central areolar choroidal dystrophy
CACG - chronic angle closure glaucoma
CAD - coronary artery disease
CADASIL - cerebral autosomal dominant arteriopathy with subcortical infarcts and leukoencephalopathy
CAI - carbonic anhydrase inhibitor
CAR - cancer associated retinopathy
CAS - clinical activity score
CB - ciliary body
CC - carotid cavernous, corpus callosum
CCC - continuous curvilinear capsulorrhexis
CCDD - congenital cranial dysinnervation disorders
CCP - cyclic citrullinated peptide
CCT - central corneal thickness
CD - cell density
CDB - corneal dystrophy of the Bowman layer
CDCR - conjunctivodacryocystorhinostomy
CEIOL - cataract extraction with intraocular lens placement
CF - counting fingers
CFEOM - congenital fibrosis of the extraocular muscles
CFH - complement factor H
CH - clock hours, Chediak Higashi
CHED - congenital hereditary endothelial dystrophy
CHRPE - congenital hypertrophy of the retinal pigment epithelium
CIN - conjunctival intraepithelial neoplasia
CME - cystoid macular edema
CML - chronic myelogenous leukemia
CMM - choroidal malignant melanoma
CMV - cytomegalovirus
CN[2345(1|2|3)678PS](P) - cranial nerve [possible nerves (possible CN5 branches) parasympathetics, sympathetics] palsy
CNS - central nervous system
CNTGS - Collaborative Normal Tension Glaucoma Study
CNV - choroidal neovascularization
COMA - congenital oculomotor apraxia
COMS - Collaborative Ocular Melanoma Study
CON - compressive optic neuropathy
COPD - chronic obstructive pulmonary disease
CPA - cerebellopontine angle
CPEO - chronic progressive external ophthalmoplegia
CPF - capsulopalpebral fascia
CPL - chloramphenicol
CPMC - California Pacific Medical Center
CR - chorioretinal, chorioretinitis
CRA - chorioretinal atrophy
CRAO - central retinal artery occlusion
CRP - C reactive protein
CRVO - central retinal vein occlusion
CSC - central serous chorioretinopathy
CSCB - ciliospinal center of Budge
CSCD - congenital stromal corneal dystrophy
CSDME - clinically significant diabetic macular edema
CSF - cerebrospinal fluid
CSM - central, steady, and maintained
CSNB - congenital stationary night blindness
CST - central subfield thickness
CT - computed tomography
CT-DCG - computed tomography dacryocystogram
CTL - contact lens
CTLA4I - cytotoxic T lymphocyte associated protein 4 inhibitors (ipilimumab)
CTR - capsular tension ring
CTS - capsular tension segment
CV - coefficient of variation
CVA - cerebrovascular accident
CVF - confrontational visual fields
CWS - cotton wool spots
CXR - chest X ray
DALK - deep anterior lamellar keratoplasty
DCCT - Diabetes Control and Complications Trial
DCG - dacryocystogram
DCP - deep capillary plexus
DCR - dacryocystorhinostomy
DDT - dye disappearance test
DDx - differential diagnosis
DES - dry eye syndrome
DFA - direct fluorescent antibody
DFE - dilated fundus exam
DHA - docosahexanoic acid
DIC - disseminated intravascular coagulation
DKA - diabetic ketoacidosis
DLK - diffuse lamellar keratitis
DLS - double layer sign
DM - diabetes mellitus
DMEK - Descemet membrane endothelial keratoplasty
DMS - dorsal midbrain syndrome
DNA - deoxyribonucleic acid
DR - diabetic retinopathy
DRCR - Diabetic Retinopathy Clinical Research Network
DRIL - disorganization of the retinal inner layers
DRS - Diabetic Retinopathy Study
DRSS - diabetic retinopathy severity score
DS-DCG - digital subtraction dacryocystography
DSEK - Descemet stripping endothelial keratoplasty
DSG - radionucleotide dacryoscintigraphy
DUSN - diffuse unilateral subacute neuroretinitis
DVD - dissociated vertical deviation
DVST - dural venous sinus thrombosis
DW - Dandy Walker
DWI - diffusion weighted imaging
E - esophoria
E' - esophoria at near
E(T) - intermittent esotropia
EBMD - epithelial basement membrane dystrophy
EBRT - external beam radiation therapy
EBV - Epstein Barr virus
ECA - external carotid arter
ECCE - extracapsular cataract extraction
ED - epithelial defect
EffRP - effective refractive power
EGF - epidermal growth factor
EGS - European Glaucoma Society
EIA - enzyme immunoassay
EKC - epidemic keratoconjunctivitis
ELP - effective lens position
EM - erythema multiforme
EMG - electromyelogram
EMGT - Early Manifest Glaucoma Trial
ENA - extractable nuclear antigen
ENT - ear, nose, and throat
EOG - electrooculogram
EOM - extraocular movements
EPA - eicosapentanoic acid
ERD - exudative retinal detachment
ERG - electroretinogram
ERM - epiretinal membrane
ESCRS - European Society of Cataract and Refractive Surgeons
ESCS - enhanced S cone syndrome
ESR - erythrocyte sedimentation rate
ET - esotropia
ETDRS - Early Treatment of Diabetic Retinopathy Study
ETOMS - Early Treatment of Multiple Sclerosis Study
ETROP - Early Treatment of Retinopathy of Prematurity Study
EUA - examination under anesthesia
EUGOGO - European Group on Graves Orbitopathy
EW - Edinger Westphal
EZ - ellipsoid zone
FAF - fundus autofluorescence
FAP - familial adenomatous polyposis
FAZ - foveal avascular zone
FB - foreign body
FBC - full blood count
FECD - Fuchs endothelial corneal dystrophy
FED - Fuchs endothelial dystrophy
FES - floppy eyelid syndrome
FEVR - familial exudative vitreoretinopathy
FFA - fundus fluorescein angiography
FFB - Foundation Fighting Blindness
FH - family history
FISH - fluorescence in situ hybridization
FL - fixation losses
FML - fluorometholone
FN - false negatives
FNA - fine needle aspiration
FP - false positives
FSHD - facioscapulohumeral dystrophy
FSRT - fractionated stereotactic radiation therapy
FTA-ABS - fluorescent treponemal antibody absorption
FTSG - full thickness skin graft
FU - follow up
FUS - Fuchs uveitis syndrome
G6PD - glucose 6 phosphate dehydrogenase
GA - general anesthesia, geographic atrophy
GCA - giant cell arteritis
GCC - glaucomatocyclitic crisis
GCL - ganglion cell layer
GCP - glaucoma change probability
GCT - galactosemia reflex test
GDx - (brand name scanning laser polarimetry glaucoma diagnosis device)
GFR - glomerular filtration rate\
GH - growth hormone
GHT - glaucoma hemifield test
GI - gastrointestinal
GLT - Glaucoma Laser Trial
GNR - gram negative rods
GON - glaucomatous optic neuropathy
GP - general practitioner
GPA - granulomatosis with polyangiitis
GVF - Goldmann visual field
GVHD - graft versus host disease
HA - headache
HAART - highly active antiretroviral therapy
HCDR - horizontal cup to disc ratio
HDL - high density lipoprotein
HEDS - Herpetic Eye Disease Study
HFL - Henle fiber layer
HHV - human herpesvirus
HI - Harada Ito
HIV - human immunodeficiency virus
HLA - human leukocyte antigen
HM - hand motion
HORV - hemorrhagic occlusive retinal vasculitis
HP - Hermansky Pudlak
HPF - high power field
HPV - human papillomavirus
HR - hyperreflective
HRA - Heidelberg Retina Angiograph
HSM - hepatosplenomegaly
HSV - herpes simplex virus
HT - hypertropia
HTLV - human T lymphotropic virus
HTN - hypertension
HVF - Humphrey visual field
IA - irrigation aspiration
IBD - inflammatory bowel disease
IBW - ideal body weight
ICA - internal carotid artery
ICE - iridocorneal endothelial syndrome
ICG - indocyanine green
ICP - intracranial pressure
ICU - intensive care unit
ID - infectious disease
IFIS - intraoperative floppy iris syndrome
IGF - insulin like growth factor
IgG4-ROD - immunoglobulin G4 related ophthalmic disease
IIH - idiopathic intracranial hypertension
IK - interstitial keratitis
ILM - internal limiting membrane
IM - intramuscular
IMRT - intensity modulated radiation therapy
IMSLO - inferior, medial, superior, lateral, oblique
IMT - idiopathic macular telangiectasia, immunomodulatory therapy
IN - inferonasal
INL - inner nuclear layer
INO - internuclear ophthalmoplegia
INR - international normalized ratio
IO - inferior oblique
IOFB - intraocular foreign body
IOL - intraocular lens
IOOA - inferior oblique overaction
IOP - intraocular pressure
IPD - interpupillary distance
IPE - iris pigment epithelium
IPL - intense pulsed light
IR - infrared reflectance, inferior rectus, intraretinal, internal reflectivity
IRF - intraretinal fluid
IRH - intraretinal hemorrhage
IRMA - intraretinal microvascular abnormality
IRVAN - idiopathic retinal vasculitis, aneurysms, and neuroretinitis
ISNT - inferior, superior, nasal, temporal
IT - inferotemporal
ITM - inferior tarsal muscle
ITP - idiopathic thrombocytopenic purpura
IV - intravenous
IVDU - intravenous drug use
IVIG - intravenous immunoglobulin G
IVMP - intravenous methylprednisolone
IVT - intravitreal triamcinolone
JCRS - Journal of Cataract and Refractive Surgery
JIA - juvenile idiopathic arthritis
JOAG - juvenile open angle glaucoma
JXG - juvenile xanthogranuloma
JXLR - juvenile X linked retinoschisis
KC - keratoconjunctivitis
KCN - keratoconus
KP - keratic precipitates
KRS - keratorefractive surgery
Ks - keratometry (measurements)
LASEK - laser epithelial keratomileusis
LASIK - laser assisted in situ keratomileusis
LCA - Leber congenital amaurosis
LCPUFA - long chain polyunsaturated fatty acids
LCT - lateral canthal tendon
LD - lattice degeneration
LDL - low density lipoprotein
LE - left eye
LEC - lenticular epithelial cells
LED - light emitting diode
LFT - liver function tests
LGN - lateral geniculate nucleus
LHON - Leber hereditary optic neuropathy
LISN - Leber idiopathic stellate neuroretinitis
LL - lower lid
LLL - left lower lid
LLR - lower lid retractors
LM - lymphatic malformation
LMA - laryngeal mask anesthesia
LMN - lower motor neuron
LoGTS - Low Pressure Glaucoma Treatment Study
LORD - late onset retinal degeneration
LOT - lateral orbital tubercle
LP - lumbar puncture
LPI - laser peripheral iridotomy
LR - lateral rectus
LRI - limbal relaxing incisions
LSC - limbal stem cells
LSCD - limbal stem cell deficiency
LT - lens thickness
LTP - laser trabeculoplasty
LTS - lateral tarsal strip
LUL - left upper lid
MALE - medial toward the apex, lateral toward the empty space
MALT - mucosa associated lymphoid tissue
MAR - melanoma associated retinopathy
MC - multifocal choroiditis
MC ± P - multifocal choroiditis, with or without panuveitis
MCE - micrycystic edema
MCT - medial canthal tendon
MED - monocular elevation deficiency
MEK - the set of genes encoding mitogen activated protein kinase kinase
MEKI - MEK inhibitors (trametinib, cobimetinib)
MELAS - mitochondrial encephalopathy, lactic acidosis, and stroke like episodes
MEN - multiple endocrine neoplasia
mETDRS - modified Early Treatment of Diabetic Retinopathy Study
MEWDS - multiple evanescent white dot syndrome
MF - motor fusion, multifocal
MFERG - multifocal electroretinogram
MFIOL - multifocal intraocular lens
MFVEP - multifocal visual evoked potential
MG - myasthenia gravis
MGD - meibomian gland dysfunction
MGUS - monoclonal gammopathy of undetermined significance
MH - macular hole
MHA-TP - microhemagglutination assay for Treponema pallidum
MI - myocardial infarction
MIDAS - microphthalmia, dermal aplasia, and sclerocornea
MIDD - maternally inherited diabetes and deafness
MIRM - Mycoplasma pneumoniae-induced rash and mucositis
MLF - medial longitudinal fasciculus
MLPA - multiplex ligation dependent probe amplification
MMC - mitomycin C
MMG - mixed mechanism glaucoma
MMP - matrix metalloproteinase
MMT - maximum medical therapy
MNP - macular nonperfusion
MOTAS - Monitored Occlusion Treatment of Amblyopia Study
MPGN - membranoproliferative glomerulonephritis
MPS - mucopolysaccharide
MR - medial rectus
MR-DCG - magnetic resonance dacryocystography
MRA - magnetic resonance angiography
MRD - margin reflex distance
MRI - magnetic resonance imaging
MRSA - methicillin resistant Staphylococcus aureus
MRV - magnetic resonance venography
MRx - manifest refraction
MS - multiple sclerosis
MVP - mitral valve prolapse
MVR - microvitreoretinal (blade)
NAI - nonaccidental injury
NAION - nonarteritic anterior ischemic optic neuropathy
NARP - neuropathy, ataxia, and retinitis pigmentosa
NC - noncontiguous
NCL - neuronal ceroid lipofuscinoses
NE - norepinephrine
NF - neurofibromatosis
NFL - nerve fiber layer
NGS - next generation sequencing
NHL - nonHodgkin lymphoma
NHS - (United Kingdom) Natiional Health Service
NIR - near infrared
NMO - neuromyelitis optica
NOVL - nonorganic visual loss
NPDR - nonproliferative diabetic retinopathy
NPL - no perception of light
NR - neuroretinitis, nonreactive
NRC - normal retinal correspondence
NSAID - nonsteroidal antiinflammatory drug
NSC - nuclear sclerotic cataract
NSOI - nonspecific orbital inflammation
NTG - normal tension glaucoma
NUM - number of cells
NV - neovascular(ization)
NVAMD - neovascular age related macular degeneration
NVD - neovascularization of the disc
NVE - neovascularization elsewhere
NVG - neovascular glaucoma
NVI - neovascularization of the iris
NVK - neovascularization of the cornea
OA - ocular albinism
OAG - open angle glaucoma
OAS - orbital apex syndrome
OCA - oculocutaneous albinism
ODEMS - optic disc edema with a macular star
ODM - ophthalmodynamometry
OFT - orbital floor triamcinolone
OHS - ocular histoplasmosis syndrome
OHSU - Oregon Health Sciences University
OHTN - ocular hypertension
OHTS - Ocular Hypertension Treatment Study
OI - Ocular Instruments
OIS - ocular ischemic syndrome
OKN - optokinetic nystagmus
OMA - oculomotor apraxia
ON - optic nerve, optic neuropathy
ONL - outer nuclear layer
ONSD - optic nerve sheath decompression
ONSM - optic nerve sheath meningioma
ONTT - Optic Neuritis Treatment Trial
OOM - orbicularis oculi muscle
OP - oscillatory potential
OPD - oropharyngeal dystrophy
OPL - outer plexiform layer
OR - or, odds ratio, outer retinal
OSA - obstructive sleep apnea
OSCE - objective structured clinical examination
OSD - ocular surface disease
OSSN - ocular surface squamous neoplasia
OT - operating theatre
OTR - ocular tilt reflex
OTS - ocular trauma score
OVD - ophthalmic viscosurgical device
PAC - primary angle closure
PACD - primary angle closure disease
PACG - primary angle closure glaucoma
PACS - primary angle closure suspect
PAM - primary acquired melanosis
PAMM - paracentral acute middle maculopathy
PAN - polyarteritis nodosa, periodic alternating nystagmus
PAS - peripheral anterior synechia(e)
PBK - pseudophakic bullous keratopathy
PBT - plaque brachytherapy
PC - posterior capsule
PCA - posterior cerebral artery
PCF - pharyngoconjunctival fever
PCG - primary congenital glaucoma
PCN - penicillin
PCNSL - primary central nervous system lymphoma
PCO - posterior capsular opacity
PCR - polymerase chain reaction
PCV - polypoidal choroidal vasculopathy
PD1I - programmed cell death protein 1 inhibitors (pembrolizumab, nivolumab)
PDG - pigment dispersion glaucoma
PDGF - platelet derived growth factor
PDR - proliferative diabetic retinopathy
PDS - pigment dispersion syndrome
PED - pigment epithelial detachment
PEDIG - Pediatric Eye Disease Interest Group
PEE - punctate epithelial erosions
PEI - penetrating eye injury
PERG - pattern electroretinogram
PET-CT - positron emission tomography computed tomography
PF - Prednefrin Forte (AUS), Pred Forte (USA), preservative free
PFV - persistent fetal vasculature
PHACES - posterior fossa malformations, hemangiomas, arterial anomalies, cardiac defects and coarctation of the aorta, eye abnormalities, and sternal abnormalities
PHMB - polyhexamethylene biguanide
PIOL - primary intraocular lymphoma
PISK - pressure induced stromal keratopathy
PJ - Pneumocystis jiroveci
PK - penetrating keratoplasty
PL - perception of light, preferential looking
PlGF - placental growth factor
PMB - papillomacular bundle
PMMA - polymethylmethacrylate
PMR - polymyalgia rheumatica
PNET - primitive neuroectodermal tumor
POAG - primary open angle glaucoma
POD - postoperative day
PORN - progressive outer retinal necrosis
PORT - progressive outer retinal toxoplasmosis
PP - peripapillary, peripupillary, pars plana
PPA - peripapillary atrophy
PPCD - posterior polymorphous corneal dystrophy
PPCRA - peripapillary chorioretinal atrophy
PPCRD - peripapillary chorioretinal degeneration
PPD - purified protein derivative
PPRCA - pigmented paravenous retinochoroidal atrophy
PPRF - paramedian pontine reticular formation
PPV - pars plana vitrectomy
PR - photoreceptor, pneumatic retinopexy
PRH - preretinal hemorrhage
PRK - photorefractive keratectomy
PRP - panretinal photocoagulation
PS - posterior synechiae
PSC - posterior subcapsular cataract
PSD - pattern standard deviation
PSI - pounds per square inch
PSP - progressive supranuclear palsy
PST - pulse synchronous tinnitus
PTK - phototherapeutic keratectomy
PTM - posterior trabecular meshwork
PUK - peripheral ulcerative keratitis
PUVA - phototherapy with topical psoralens + ultraviolet A
PVD - posterior vitreous detachment
PWS - port wine stain
PXE - pseudoxanthoma elasticum
PXF - pseudoexfoliation
PXG - pseudoexfoliation glaucoma
PXG - pseudoexfoliation glaucoma
Qgold - Quantiferon TB Gold
RA - rheumatoid arthritis
RACE - RANZCO Advanced Clinical Examination
RANZCO - Royal Australian and New Zealand College of Ophthalmologists
RAO - retinal artery occlusion
RAPD - relative afferent pupillary defect
Rb - retinoblastoma
RBC - red blood cells
RCES - recurrent corneal erosion syndrome
RCVS - reversible cerebral vasoconstriction syndrome
RD - retinal detachment
RE - right eye
RF - rheumatoid factor
RGP - rigid gas permeable (contact lens)
RH - Ramsay Hunt
riMLF - rostral interstitial nucleus of the medial longitudinal fasciculus
RLE - refractive lens exchange
RLL - right lower lid
RNA - ribonucleic acid
RNFL - retinal nerve fiber layer
ROP - retinopathy of prematurity
RP - retinitis pigmentosa
RPD - reticular pseudodrusen
RPEA - retinal pigment epithelial atrophy
RPED - retinal pigment epithelial detachment
RPM - revolutions per minute
RPR - rapid plasma reagin
RR - relative risk
RRD - rhegmatogenous retinal detachment
RRF - ragged red fibers
RUL - right upper lid
RV - retinal vessels
RVEEH - Royal Victorian Eye and Ear Hospital
RVF - Rift Valley fever
RVO - retinal vein occlusion
S(S|T|C) - sickle cell variants: SS, ST, SC
SA - Staphylococcus aureus
SACG - subacute angle closure glaucoma
SAH - subarachnoid hemorrhage
SALT - sequential aggressive local therapy
SB - scleral buckle
SC - subconjunctival, subcutaneous
SCC - squamous cell carcinoma
SCG - superior cervical ganglion
SCH - subconjunctival hemorrhage
SD - standard deviation
SDD - subretinal drusenoid deposits
SE - spherical equivalent, Staphylococcus epidermidis, subepithelial
SEAGIG - Southeast Asia Glaucoma Interest Group
SEI - subepithelial infiltrates
SF - sensory fusion
SFU - subretinal fibrosis and uveitis
SG - Sheridan Gardner
SHRM - subretinal hyperreflective material
SINS - surgically induced necrotizing scleritis
SJS - Stephens Johnson syndrome
SL - Schwalbe line
SLK - superior limbic keratoconjunctivitis
SLMD - Stargardt like macular dystrophy
SLO - scanning laser ophthalmoscope
SLP - scanning laser polarimetry
SLT - selective laser trabeculoplasty
SmILE - small incision lenticule extraction
SN - superonasal, spasmas nutans
SNP - single nucleotide polymorphism
SNPDR - severe nonproliferative diabetic retinopathy
SNR - signal to noise ratio
SO - silicone oil, sympathetic ophthalmia, superior oblique
SOOA - superior oblique overaction
SP - simultaneous perception
SPA - spinocerebellar atrophy
SPEP - serum protein electrophoresis
SPI - surgical peripheral iridectomy
SPK - superficial punctate keratopathy
SR - superior rectus, subretinal
SRD - subretinal deposit
SRF - subretinal fluid
SRH - subretinal hemorrhage
SRPE - sub(retinal pigment epithelium)
SS - seronegative spondyloarthropathies, scleral spur, steroid sparing
SSIMT - steroid sparing immunomodulatory therapy
SSPE - subacute sclerosing panencephalitis
SSRI - selective serotonin reuptake inhibitor
ST - superotemporal
SUN - Standardization of Uveitis Nomenclature
SWAP - short wavelength automated perimetry
TA - temporal artery
TAB - temporal artery biopsy
TASS - toxic anterior segment syndrome
TAT - trabeculectomy, argon laser trabeculoplasty, trabeculectomy
TB - tuberculosis
TBII - thyrotropin binding inhibitory immunoglobulin
TBUT - tear breakup time
TC - tarsoconjunctival
TED - thyroid eye disease
TEE - transesophageal echocardiogram
TEN - toxic epidermal necrolysis
TGF - transforming growth factor
TGFBI - transforming growth factor beta induced
TID - transillumination defects
TIN - tubulointerstitial nephritis
TINU - tubulointerstitial nephritis and uveitis
TLP - thumblike polyps
TM - trabecular meshwork
TMVL - transient monocular visual loss
TNF - tumor necrosis factor
TNFI - tumor necrosis factor inhibitors
TORCH - toxoplasma, other (adenovirus, enterovirus, hepatitis E virus, human immunodeficiency virus, lymphocytic choriomeningitis virus, measles virus, parvovirus B19, West Nile virus, syphilis), rubella, cytomegalovirus, Herpesviruses (herpes simplex virus 1, herpes simplex virus 2, varicella zoster virus)
TPF - tenacious proximal fusion
TRD - tractional retinal detachment
TSCPC - transscleral cyclophotocoagulation
TSH - thyroid stimulating hormone
TSH-R - thyroid stimulating hormone receptor
TSI - thyroid stimulating immunoglobulin
TTE - transthoracic echocardiogram
TTP - thrombotic thrombocytopenic purpura
TTT - transpupillary thermotherapy
TVO - transient visual obscurations
UBM - ultrasound biomicroscopy
UEC - urea, electrolytes, and creatinine
UES - uveal effusion syndrome
UGH - uveitis, glaucoma, hyphema
UL - upper lid
UMN - upper motor neuron
URI - upper respiratory infection
US - ultrasound
USD - United States dollar
UVA - ultraviolet A
VA - visual acuity
VB - venous beading, Vision Blue
VCDR - vertical cup to disc ratio
VDRL - Venereal Disease Research Laboratory
VEGF - vascular endothelial growth factor
VEP - visual evoked potential
VF - visual field
VH - vitreous hemorrhage
VHL - Von Hippel Lindau
VIP-HIP - Vision In Preschoolers Hyperopia in Preschoolers Study Group
VKC - vernal keratoconjunctivitis
VKH - Vogt Koyanagi Harada
VM - vascular malformation
VMD - vitelliform macular dystrophy
VMT - vitreomacular traction
VOR - vestibuloocular reflex
VP - venous pulsations
VR - vitreoretinal
VRC - vitreoretinochoroidopathy
VS - visually significant
VSAQ - very short answer questions
VST - venous sinus thrombosis
VZV - varicella zoster virus
WAGR - Wilms tumor, aniridia, genitourinary anomalies, and retardation (now called intellectual disability)
WARD - white annular retinal dystrophy
WBC - white blood cells
WDS - white dot syndromes
WEBINO - wall eyed bilateral internuclear ophthalmoplegia
WESDR - Wisconsin Epidemiologic Study of Diabetic Retinopathy
WML - white matter lesion
WNV - West Nile virus
WRT - with respect to
WTR - with the rule
WTW - white to white
X - exophoria
X' - exophoria at near
X(T) - intermittent exotropia
XLD - X linked dominant
XLR - X linked recessive
XLRP - X linked retinitis pigmentosa
XT - exotropia
YAG - yttrium aluminum garnet (usually Neodymium doped AKA Nd3+:YAG) laser
YO - years old
ZIKV - Zika virus
